11111
1P0011
1CC001
10E101
111111