111111
1P0011
1CC000
10E101
111111