111111
1P0011
1CC001
10E1P1
111111