111111
100011
1CC001
10E101
111111