111111
1P0011
100001
10E101
111111