111111
1P0011
1CC001
100101
111111