111111111111111111111111111111111111111111111111111111
1P0E1C100100000010001010000000C10000001010000000000001
10C000100101111111000000100011110011101000111111111001
100010100100000010011110111000100001100011101000110011
10C000000001111110011000100010110000110010101010100111
1000100000000000000100001111100000000000111000101111C1
10000C000000000000011000001000110000000000000010000001
111111111111111111111111111011111111111111110111111111
111100000000000000000000000001101000000001110111111111
11110000000C000000011111111111101111111101110000000001
111100000000000000011000000000001111111100000111111101
111111111111111111111001111111011111111111110110000101
111111111111111111111111111111011000000000000010111101
1000000000C000000000000000000C000000000000000010000001
101111111111111111111111111111111111111111111111111111
101110000E11110000000000000000000000001111100000111111
100111111111110000000000000000000000001100001110C01111
110100000000000011111111111111111111101101111111111111
110111111000000011111111111100000110000000000000000001
110000001111110000000000000111111110111111111111111101
111111000000011111111111110111111110111110000001111001
111111011111000000000000110111101100000000000001001111
1111110100100111111111101C0C10001000000000000001111C01
111111100100010010111110111111001000100001000000000101
1000000000000100100010001111111111111110010000010C0001
111101111010010111110010000000011101001000001000111001
1111001C1110010100000010000000111101001010001101110001
1C0000000001010100011111111110000000000000001100C100E1
111111111111111111111111111111111111111111111111111111